O O O O O O O O O O O O O O O O
O O O O O O O O O O O O O O O O
O O O O O O O O O O O O O O O O
O O O O O O O O O O O O O O O O
O O O O O O O O O O O O O O O O
O O O O O O O O O O O O O O O O
O O O O O O O O O O O O O O O O
O O O O O O O O O O O O O O O O
O O O O O O O O O O O O O O O O
O O O O O X O O O X O O O O O O
O O O O O X O O O X O O O O O O
O O O O O X O O O X O O O O O O
G G G O X X X X G X G X G G G G
G G G G G G G G G G G G G G G G
G G G G G G G G G G G G G G G G